替自己喝彩 : 还跑呢，能刹住车吗？
霁风渡星河 : 这背景音乐是哪首啊？
动石 : 自在
小乔明月 : 孤独的最高境界是自得其乐！
温芝芝 : 孤独的最高境界是不孤独[脱单doge]
原点幻想 : 找到“我”
临江仙Ccli : 音乐是哪个版本的哼唱
靓仔书云 : 好想跳下去
2266k : 开头真帅
千年慈悲 : 孤独的最高境界是融于自然
花岗岩先森 : 孤独……就是没有炮友
沉默的鹿人饼 : 孤独的最高境界是裂开了，分裂一个陪自己玩，一个不够就分裂一家。
咸盐不续 : 随风而去
命运无声可叹无言 : 孤独的最高境界就两个字，长生。
仓海遗珠 : 换我会吓尿。畏高
白金秘密 : 孤独的最高境界，就是不再觉得什么是孤独，孤独是他人眼中的感觉，于自己忠于内心而已
蟹可囍 : 法罗群岛🇫🇴
小王子与Hl的麦田 : 与万物共情，无有分别
e西西e : 自由的最高境界不是无拘束吗？心自由，人才会自由
快乐玉山 : 想想以后如果父母都不在了，你在世上所有血脉都没了，那就是孤独，佳节对影成双人，慢慢的无人问津，那就是孤独
独无限 : 自在随意
巴巴在哪 : 进盒子里
南华-蝶 : 好美，想拥抱它们，顺便死在这里[喜欢]
闹腾桃 : 最高的境界其实不是孤独，而是享受孤独。一个人能享受孤独，孤独而不孤独
欣之言 : 世间多是“好久不见”，感叹的是“一如初见”
FLY啊我就追追 : 避世  离世
光明----- : 孤独的最高境界是无我。
杨不惧 : 享受内心安宁
天相9 : 孤独的最高境界是不空虚寂寞
老马养土蜂 : 天地人
冬山梨花开 : 孤独的最高境界是不想活
cckkcckk23222 : 放飞自我与天地合一
八丨賢丨王 : 孤独的最高境界，皆空
bili_95430398713 : 彳.._步～*
眺望时间目空一切 : 永恒
没啥梦想的小周同学 : 当有一天总能微笑面对一切时，我就不觉得孤独了
universex : 是醒来[呲牙][呲牙][呲牙]
你的恩浩帅帅 : 真好
走路带风的索 : 孤独并不是贬义词，寂寞才是
国服小哥哥 : 百年孤独
漏沟奥对哦所以 : 孤独的最高境界就是不孤独
文文小音湘 : 孤独是见山高路远仍涉足，即便无人相伴，不过一声叹息
钢宝贝 : 这地方真好 我可以不顾一切的放声大哭😭
道一DY : 享受
均墨听鸿 : 这个BGM哪里可以找到，好像要啊
白嫖老祖9pro : 孤独的最高境界是自由，自由的最高境界是孤独。
诸天之师 : 是寂灭
兰风花月 : 孤独的最高境界是身归混沌[吃瓜]
LOL白羽 : 孤独的最高境界是湮灭
小星宇lyg : 孤独的最高境界就是演戏
分真即佛 : 自由[保佑][保佑][保佑]阿弥陀佛
落樱白哉 : 万物不能动其心，不以物喜不以己悲，坦然面对一切，包括生死！
离霜丶坚冰至 : 无欲则欢
墨染春萩 : 死亡
取闹自控 : 中国可没这地方，估计也就北欧或者西欧有这地方吧
情到深处帐篷高 : 孤独是没有家人没有朋友没有人找你，相当于你住深山，一个人生活，你试一下这样生活一下就知道最高境界是啥了
罗喉再生 : 是睡觉
苏穆1 : 孤独的最高境界是自由！这个自由时间指对物质与精神的无欲无求，对生与死的洒脱
-大梨梨- : 倩女幽魂和印度阿三不搭
坐骑小龙女 : 孤独的最高境界是挥刀自宫，绝不与弟弟见面[doge][doge][doge]
小酌一杯风雅 : 希望下辈子能变成一只鸟儿翱翔天际
纯可可脂巧克力蛋糕 : 孤独是自由，自由不是孤独，自由遥遥无期，孤独永无止境
紫薇星明助眠催眠疗愈 : 是灭一切存在！
谁是张三他哥 : 孤独的最高境界就是要寄了
MN丶榆钱儿 : 孤独的最高境界是陪伴
胖哥刃牙 : 孤独最高境界是甘于孤独。
都市小卡车 : 孤独～是一个人的狂欢
我无话可说鸭 : 吾心安处即是故乡。
大象海岸 : 孤独的最高境界是享受孤独，享受生命
钦天履道宣文广武帝君 : 聊乘化以归尽，乐夫天命复奚疑！
Kneeth : 道法自然
清风明月寄我乡思 : 我恐高。
看群魔乱舞丶 : 小说里才有的景色
军刺98 : 孤独的最高境界是什么我不知道，我只知道孤独久了就感觉不到孤独了。
雨落错过了晨曦 : 自我
浊酒一杯醉多情 : 孤独的最高境界是孤独的时候不孤独
剑仙不是我 : 好美啊
k天青色k : 是千里孤坟
中天夜空 : 孤独最高境界是独处
修罗i73 : 应该说，孤独的最高境界是自由！
神龙教教主洪安通 : 孤独的最高境界是，家里无任何亲戚，无任何朋友。
以奴鸭虾 : 特别想要一个飞机，小的，有身临其境的感觉
四时山河 : 孤独的最高境界是酒醒时分的黎明
ELM-ChaN : 倩女幽魂
思菩提 : 我并非自由，是因我还有心中的孤独。我并非孤独，是因我还有眼中的风景。自由并非孤独。只因还有我无法摆脱的束缚。
自由是我最大的追求 : 孤独的最高境界是无所畏惧
羊羊不吃草呀 : 没人在乎吧，你的存在是在于别人对你有没有念想
须弥方寸山 : 孤独就是不点赞，不关注，看看了事
少女心中的爱 : 孤独的最高境界是看透社会的本质看透人心
六阳灵佑真君 : 独行
想睡--- : 虚无与无我
bili_4578966642 : 一个人住院
苦的灭尽 : 解脱之道，就在其中。
孙吧黄牌萌新 : 无我
b小jiang的野叠 : 看地理环境，很多都像是北欧的
染墨源 : 活着
风雨梨花香 : 孤独就像一株草，野火烧不尽，春风吹又生。看潮起潮落，朝阳起，晚霞落，云淡风轻。听的是风声雨声雷声，却始终沉默，无言以对时间冲刷。
-知渔- : 孤独的最高境界就是享受孤独
鑫宸乐园 : 无所谓畏惧
吐奶童年 : 是自由
bili_36834812537 : 宁静的地方
三岁秃了头 : 睡觉
一樽还酹江月i : 不以物喜，不以己悲
热爱生活拥抱自然 : 是独孤
logocatgod : 大数据死了关闭就是开心
84625828198_bili : 都是扯淡孤单还要最高境界，一颗子弹都吓尿裤子
恒钊钊 : 孤独的最高境界就是不孤独
天下时闻 : 是结婚
CelEsTial__ : 听着像奥日2
PepeIforgot : 今年无论如何，一定要一个人出去旅游一次[Cat2_IsLiquid!]
橙子牛仔 : 其实我们完全没必要去追求所谓的“最高境界”，无论是抽象还是具象，其实没有什么事物会是“最高境界”的，任何事物都会有其对应的更高的事物所替代。

我们不妨换个观念，不去刻意追求“最高境界”，也许我们就会发现，“最高境界”就存在我们身边，在我们所接触的任何事物中；当你以美以爱以自然的态度去看待事物，你就会发现“最高境界”并不存在，“最高境界”也无处不在，即世间无我，处处是我。
罗斯特拉维夫 : 这草，似曾相识的感觉
玩乐丶风车丶林 : 核弹[吃瓜]
路费都煤油 : 享受体验人生的过程
工具人0527 : 我就觉得自己是个屁，全世界也是个屁。现在活的好舒服[星星眼]
鸡蛋大灌篮 : 好美[星星眼]
不问源因 : 孤独的最高境界还是是宁静
渐臻佳境1999 : 1分22秒的景，是哪里？
小春子欧耶 : 美，就一个字。
是顾恋轻尘 : 是蜕变，此时将不再惧怕孤独，而是享受每一个独处的时刻
国服栋梁工程师 : 孤独的最高境界还是孤独
实力摇摆不定 : 孤独的最高境界是自我救赎
白附子啊 : 哈哈，看到那上面的木板了嘛？我现在要跳上去。一二三，起跳！哎呀，好像这个木桥有点断了。嘶
李做梦Reilly : 孤独最高境界就是独断万古
隗奢 : 具体的还说不出来，这样看吧：习惯孤独的人会开始想做什么就做什么，没有寿命观念的做事，假设做过很多事，能想象到的都做完了，仰头便什么都看不到，但低头脚下的全是经历过的，像满级游戏角色再也加不了一点技力一样，目前只能看到些虚无。但是还没达到的东西谁也说不清呢
浮光一TheHistory : 感觉大部分好看的地方都被旅游风景区公司污染了
vipokk : [星星眼]
